10 9
= = = = = = = = =
= 0 0 0 0 0 0 0 =
= X 0 0 0 B 0 0 =
= O 0 0 0 B 0 0 =
= 0 0 0 0 0 0 B =
= = = = = = 0 0 =
= O 0 0 0 0 B 0 =
= 0 0 0 0 O = = =
= 0 O 0 0 0 0 0 =
= = = = = = = = =
